#
test level
#
Geti
#
2|2|2
#
0000000000000000000000000
0000000000000000000000000
1111110000000000000000000
1111100000000000000000000
1110000000000000000000000
1100000000000000000000000
1100000001100000000000000
1111111111000011000000000
1111111110000011111110000
1111111111100011111111111
1111111111100001111111111
1111110000100000000111111
1110000000000000000011111
1110000000000000000011111
1110000000000111100011111
1111001111111111111111111
1111001111111111111111111/
0000000000000000000000000
0000000000000000000000000
0000000000000000000000000
0000000000000000000000000
0000000000000000000000000
0000000000000000000000000
0000000000000000000000000
0000000000000000000000000
0000000000000000000000000
0000000000000000000000000
0000000000000000000000000
0000000000000000000000000
0000000000000011000000000
0000000000000011000000000
0000000000000000000000000
0000000000000000000000000
0000000000000000000000000/|

1111111111111111111111111
1111111111111111111111111
1111111111111111111111111
1111111111111111111111111
1111111111111111111111111
1111111111111111111111111
1111111111111111111111111
1111111111111111111111111
1111111111111111111111111
1111111111111111111111111
1111111111100001111111111
1111100111100000000011111
1110000011110000000000111
1110000000000000000000111
1111111111111111000000111
1111111111111111000111111
1111111111111111001111111/
0000000000000000000000000
0000000000000000000000000
0000000000000000000000000
0000000000000000000000000
0000000000000000000000000
0000000000000000000000000
0000000000000000000000000
0000000000000000000000000
0000000000000000000000000
0000000000000000000000000
0000000000000000000000000
0000000000000000000000000
0000000000000022000000000
0000000000000022000000000
0000000000000000000000000
0000000000000000000000000
0000000000000000000000000/|

1111001111111111111111111
1111001111111100000000000
1110011110000000000000000
1110011100000000000000000
1110000000000000000000001
1110000000000000000000001
1111000000000000000111111
1111100000000000111111111
1111111000000111111111111
1111111100000111110000111
1111111000000000000000001
1111110000000000000000001
1100000000000000000000001
1000000000000000000000001
1000000000001111000000000
1111111111111111011000000
1111111111111111111111111/
0000000000000000000000000
0000000000000000000000000
0000000000000000000000000
0000000000000000000000000
0000000000000000000000000
0000000000000000000000000
0000000000000000000000000
0000000000000000000000000
0000000000000000000000000
0000000000000000000000000
0000000000000000000000000
0000000000000000000000000
0000000000000000000000000
0000110000000000000000000
0000110000000000000000000
0000000000000000000000000
0000000000000000000000000/|
1111111111111111001111111
1111111111111110001111111
1111111111111110001111111
1111111111111110011111111
1111111111100000000001111
1111111100000000000000111
1111111000001111100001111
1111000000001111111011111
1111000110000001111011111
1111001111100000011011111
1111000100000000011001111
1111100000000111111001111
1111110000011111111011111
1111000000000000111011111
1111000000000000000011111
1111111111111100000011111
1111111111111111111111111/
0000000000000000000000000
0000000000000000000000000
0000000000000000000000000
0000000000000000000000000
0000000000000000000000000
0000000000000000000000000
0000000000000000000000000
0000000000000000000000000
0000000000000000000000000
0000000000000000000000000
0000000000000000000000000
0000000000000000000000000
0000000000000000000000000
0000220000000000000000000
0000220000000000000000000
0000000000000000000000000
0000000000000000000000000/|

0000000000000000000000000
0000000000000000000000001
0000000000000000000000011
0000000000000000000000011
0000000000000000000000011
0000000000000000000001111
0000000000000000001111111
0000000000000000000111111
0000000000000110000000011
1100011111000000000000001
1111111111000000000000001
1111111111110000000000001
1111111111111111110000001
1111111100000011110000011
1111111000000000000000011
1111111000000000000001111
1111111110011111111111111//|

//|

1111111110011111111111111
0001110000011111111111111
0001110000011111111111111
0000100001111110000000001
1000000001110000000000001
1000000011110000111000001
1000110000000011111000001
1100000000000011111100111
1110000111111001110000111
1111111111100000000001111
1111110001110000000001111
1111100001100000011111111
1100000000000001111111111
1000001100000011111111111
0000001100111111111111111
0000111111111111111111111
1111111111111111111111111//|

//
#
120|100|1|1|1
#

nb; currently // is an empty level. the editor should probably output empties like that to prevent wasted data space.
